# Syntax Coloring Map For 'libraries/PDM'

# Datatypes (KEYWORD1)
ap3_pdm_pad_type_e	KEYWORD1
AP3_PDM	KEYWORD1

# Functions (KEYWORD2)
begin	KEYWORD2
available	KEYWORD2
isOverrun	KEYWORD2
setClockSpeed	KEYWORD2
getClockSpeed	KEYWORD2
setClockDivider	KEYWORD2
getClockDivider	KEYWORD2
setLeftGain	KEYWORD2
getLeftGain	KEYWORD2
setRightGain	KEYWORD2
getRightGain	KEYWORD2
setGain	KEYWORD2
setChannel	KEYWORD2
getChannel	KEYWORD2
setDecimationRate	KEYWORD2
getDecimationRate	KEYWORD2
updateConfig	KEYWORD2
getData	KEYWORD2
pdm_isr	KEYWORD2
ap3_pdm_pad_funcsel	KEYWORD2

# Structures (KEYWORD3)
ap3_pdm_pad_map_elem_t	KEYWORD3

# Constants (LITERAL1)
_PDM_H_	LITERAL1
AP3_PDM_NUM_DATA_PADS	LITERAL1
AP3_PDM_NUM_CLOCK_PADS	LITERAL1
MIC_DATA	LITERAL1
MIC_CLOCK	LITERAL1
_pdmBufferSize	LITERAL1
AP3_PDM_DATA	LITERAL1
AP3_PDM_CLOCK	LITERAL1

# Properties (LITERAL2)
pad	LITERAL2
funcsel	LITERAL2
