# Syntax Coloring Map For '.'

# Datatypes (KEYWORD1)
UART	KEYWORD1
InterruptInParam	KEYWORD1
ap3_err_t	KEYWORD1
ap3_adc_internal_channel_e	KEYWORD1

# Functions (KEYWORD2)
UART	KEYWORD2
rxISR	KEYWORD2
begin	KEYWORD2
end	KEYWORD2
available	KEYWORD2
peek	KEYWORD2
read	KEYWORD2
flush	KEYWORD2
write	KEYWORD2
printf	KEYWORD2
operatorbool	KEYWORD2
InterruptInParam	KEYWORD2
rise	KEYWORD2
fall	KEYWORD2
_irq_handler	KEYWORD2
indexPinMode	KEYWORD2
pinMode	KEYWORD2
indexDigitalWrite	KEYWORD2
digitalWrite	KEYWORD2
indexDigitalRead	KEYWORD2
digitalRead	KEYWORD2
indexAnalogRead	KEYWORD2
analogRead	KEYWORD2
indexAnalogWriteDAC	KEYWORD2
analogWriteDAC	KEYWORD2
indexAnalogWrite	KEYWORD2
analogWrite	KEYWORD2
indexShiftOut	KEYWORD2
shiftOut	KEYWORD2
indexShiftIn	KEYWORD2
shiftIn	KEYWORD2
indexAttachInterrupt	KEYWORD2
attachInterrupt	KEYWORD2
indexAttachInterruptParam	KEYWORD2
attachInterruptParam	KEYWORD2
indexDetachInterrupt	KEYWORD2
detachInterrupt	KEYWORD2
indexTone	KEYWORD2
indexPulseIn	KEYWORD2
pulseIn	KEYWORD2
indexPulseInLong	KEYWORD2
pulseInLong	KEYWORD2
powerControlADC	KEYWORD2
analogWriteResolution	KEYWORD2
analogWriteFrameWidth	KEYWORD2
analogWriteFrequency	KEYWORD2
getServoResolution	KEYWORD2
servoWriteResolution	KEYWORD2
servoWrite	KEYWORD2
analogReadResolution	KEYWORD2
analogReadDiff	KEYWORD2
analogReadTemp	KEYWORD2
analogReadVCCDiv3	KEYWORD2
analogReadVSS	KEYWORD2
initializeADC	KEYWORD2

# Structures (KEYWORD3)
ap3_adc_channel_config_t	KEYWORD3

# Constants (LITERAL1)
_ARDUINO_MBED_BRIDGE_CORE_EXTEND_HARDWARESERIAL_H_	LITERAL1
RX_BUF_LEN	LITERAL1
_ARDUINO_MBED_BRIDGE_CORE_EXTEND_ARDUINOAPI_H_	LITERAL1
_ARDUINO_MBED_BRIDGE_CORE_EXTEND_COMMON_H_	LITERAL1
PinMode	LITERAL1
_ARDUINO_SDK_CORE_EXTEND_POWER_CONTROL_H_	LITERAL1
_ARDUINO_SDK_CORE_EXTEND_COMMON_H_	LITERAL1
_ARDUINO_SDK_CORE_EXTEND_AP3_TYPES_H_	LITERAL1
digitalPinToInterrupt(P)	LITERAL1
AP3_OK	LITERAL1
AP3_ERR	LITERAL1
AP3_INVALID_HANDLE	LITERAL1
AP3_IN_USE	LITERAL1
AP3_TIMEOUT	LITERAL1
AP3_OUT_OF_RANGE	LITERAL1
AP3_INVALID_ARG	LITERAL1
AP3_INVALID_OPERATION	LITERAL1
AP3_MEM_ERR	LITERAL1
AP3_HW_ERR	LITERAL1
AP3_MODULE_SPECIFIC_START	LITERAL1
_ARDUINO_SDK_CORE_EXTEND_ANALOG_INTERNAL_H_	LITERAL1
AP3_ADC_INTERNAL_CHANNELS_DIFF0	LITERAL1
AP3_ADC_INTERNAL_CHANNELS_DIFF1	LITERAL1
AP3_ADC_INTERNAL_CHANNELS_TEMP	LITERAL1
AP3_ADC_INTERNAL_CHANNELS_VCC_DIV3	LITERAL1
AP3_ADC_INTERNAL_CHANNELS_VSS	LITERAL1
AP3_ADC_INTERNAL_CHANNELS_NUM	LITERAL1

# Properties (LITERAL2)
write	LITERAL2
Serial	LITERAL2
pinNumber	LITERAL2
internal_channel	LITERAL2
eChannel	LITERAL2
funcsel	LITERAL2
ap3_adc_channel_configs	LITERAL2
